*****************************************************************
*A        *       *        *            *   *   *     *   *     *
* ***** * ***** *** ********** ** ****  * * * * *** * * * ***** *
*   * * *     *     *             *  *  * *   *     *   *       *
*** * * ***** ********* ******* * **** ** ***************** * ***
*     *   *       *   *       * *             *         *   *   *
* ** ** * ******* * * * * *** * * ***** ***** **** **** * ***** *
* *   * *   *   *   *   *   *   *     * *   * *     *   * *     *
*** * *** * * * *** * * * * *** * *** * * ********* * * * * *** *
*   *   * * * *   *   * * * *   *     *   *     *   * * *   * * *
* ***** * * * *** * *** * * ** ** ******* * *** * *** * ***** * *
*   *         *   * * * * *       *     * * * *   *   *   *     *
* * * ***** *** *** * * * ********* ***** * * ***** ***** * *** *
* *   *         *   *   *         *         *   *       *   *   *
* * *** ***** * * *** * ***** *** ********* * * * ***** * *** ***
* *       *   *       *                     * *       *        B*
*****************************************************************
